+++++++++++++++++++++++
+   +   ++           ++
+     +     +++++  ++++
++++ ++++++++ +++  ++++
+ +   + + ++    ++   ++
+          ++  ++  + ++
+++++++ +      ++  + ++
++++++++++++ +  ++   ++
+               + +  ++
+ ++++++++ + +      S++
+ +++++++++++++++++++++